LevelData(tiles: [
 [0,0,0,0,1,1,1,1,1,1,1,1,1,1]
,[0,1,1,1,1,0,0,0,0,0,0,0,0,1]
,[1,1,0,0,1,0,1,1,1,1,1,1,0,1]
,[1,0,0,0,0,0,0,0,0,0,0,1,0,1]
,[1,0,0,0,0,1,0,0,0,0,0,0,0,1]
,[1,1,1,0,0,1,0,0,0,0,0,1,1,1]
,[0,1,1,0,0,1,0,1,1,0,0,1,0,0]
,[0,1,0,0,0,0,0,0,1,0,1,1,0,0]
,[0,1,1,1,0,0,0,0,0,0,1,0,0,0]
,[0,1,0,0,0,0,0,0,1,0,1,0,0,0]
,[0,1,0,1,0,0,0,1,1,0,1,0,0,0]
,[0,1,0,1,1,1,1,1,0,0,1,1,0,0]
,[0,1,0,0,0,0,0,0,0,0,0,1,0,0]
,[0,1,1,1,0,0,0,0,0,0,0,1,0,0]
,[0,0,0,1,0,0,0,0,0,0,0,1,0,0]
,[0,0,0,1,1,1,1,1,1,1,1,1,0,0]
],
boxes: [[4,9],[5,8],[7,8],[4,7],[9,7],[3,6],[6,5],[7,5],[10,5],[4,4],[2,3],[5,3],[7,3],[9,3]],
goals: [[4,14],[5,14],[6,14],[7,14],[8,14],[9,14],[10,14],[4,13],[5,13],[6,13],[7,13],[8,13],[9,13],[10,13]],
start: [2,7]
),