LevelData(tiles: [
 [0,0,0,0,1,1,1,1,1,0,0,0,0,0,0,0,0]
,[1,1,1,1,1,0,0,0,1,0,0,0,0,0,0,0,0]
,[1,0,0,1,1,0,1,0,1,0,0,0,0,0,0,0,0]
,[1,0,0,0,0,0,0,0,1,0,0,0,0,0,0,0,0]
,[1,0,0,0,1,1,1,0,1,1,1,1,1,1,1,1,1]
,[1,1,1,0,0,0,0,0,1,1,0,0,0,0,0,0,1]
,[0,1,1,0,0,0,0,0,0,0,0,0,0,0,0,0,1]
,[0,1,0,0,0,0,0,0,1,1,0,0,0,0,0,0,1]
,[0,1,1,0,0,0,0,0,1,1,1,1,1,1,1,1,1]
,[0,1,0,0,0,0,0,0,1,0,0,0,0,0,0,0,0]
,[0,1,0,1,1,0,1,1,1,0,0,0,0,0,0,0,0]
,[0,1,0,0,0,0,1,0,0,0,0,0,0,0,0,0,0]
,[0,1,1,1,1,1,1,0,0,0,0,0,0,0,0,0,0]
],
boxes: [[4,9],[6,9],[5,8],[4,7],[7,7],[4,6],[5,6],[7,6],[3,5],[6,5],[2,3],[5,2]],
goals: [[12,7],[13,7],[14,7],[15,7],[12,6],[13,6],[14,6],[15,6],[12,5],[13,5],[14,5],[15,5]],
start: [2,7]
),