LevelData(tiles: [
 [0,0,0,1,1,1,1,1,0,0,0,0,0,0,0,0,0]
,[0,0,0,1,0,0,0,1,1,1,1,1,0,0,0,0,0]
,[1,1,1,1,0,0,0,0,0,0,0,1,1,0,0,0,0]
,[1,0,1,1,0,0,0,0,0,0,0,0,1,1,1,1,1]
,[1,0,0,1,1,0,0,0,0,0,0,0,0,0,0,0,1]
,[1,0,0,0,1,1,1,0,1,1,1,1,1,1,0,0,1]
,[1,0,0,0,0,1,0,0,0,0,1,0,0,1,0,1,1]
,[1,0,0,0,0,1,0,0,0,0,1,0,0,0,0,0,1]
,[1,0,0,0,1,1,1,1,0,1,1,0,0,1,0,0,1]
,[1,0,0,1,1,0,0,0,0,0,0,0,0,1,1,1,1]
,[1,0,0,0,0,0,0,0,0,0,0,0,0,1,0,0,0]
,[1,0,0,0,1,0,0,0,0,0,0,0,1,1,0,0,0]
,[1,1,1,1,0,0,0,0,0,0,0,0,1,0,0,0,0]
,[0,0,0,1,0,0,0,1,1,1,1,1,1,0,0,0,0]
,[0,0,0,1,1,1,1,1,0,0,0,0,0,0,0,0,0]
],
boxes: [[6,12],[8,12],[6,11],[9,11],[10,11],[4,10],[7,10],[9,10],[7,9],[8,9],[10,9],[12,8],[14,7],[7,4],[8,4],[5,3],[7,3],[10,3],[6,2],[9,2]],
goals: [[1,11],[1,10],[2,10],[3,10],[1,9],[2,9],[1,8],[2,8],[3,8],[2,7],[3,7],[4,7],[2,6],[3,6],[4,6],[2,5],[3,5],[1,4],[2,4],[1,3]],
start: [15,8]
),