LevelData(tiles: [
 [0,0,0,0,0,0,0,0,0,0,0,0,0,0,1,1,1,1,1]
,[0,0,0,0,0,0,0,0,0,0,0,0,0,1,1,0,0,0,1]
,[0,0,0,0,0,1,1,1,1,1,1,1,1,1,0,0,0,0,1]
,[1,1,1,1,1,1,0,0,0,0,0,0,0,1,0,1,0,1,1]
,[1,0,0,0,1,0,0,0,1,0,1,0,0,0,0,1,0,1,1]
,[1,0,0,0,0,0,1,0,0,0,0,0,0,0,0,1,0,0,1]
,[1,1,0,1,1,1,1,1,1,1,1,1,0,1,1,1,0,0,1]
,[1,1,0,1,0,0,0,0,0,0,0,0,0,0,1,1,0,0,1]
,[1,1,0,1,0,0,0,0,0,0,0,0,0,0,1,1,0,1,1]
,[1,0,0,1,1,0,1,1,1,1,1,1,1,1,1,1,0,0,1]
,[1,0,0,0,0,0,0,0,0,0,0,0,0,0,0,0,0,0,1]
,[1,0,0,1,0,0,0,1,0,0,0,1,0,0,0,1,0,0,1]
,[1,1,1,1,1,1,1,1,1,1,1,1,1,1,1,1,1,1,1]
],
boxes: [[3,10],[8,10],[11,10],[15,10],[2,9],[16,9],[2,5],[8,5],[9,4],[11,4],[16,2]],
goals: [[6,8],[8,8],[9,8],[11,8],[5,7],[6,7],[7,7],[8,7],[9,7],[11,7],[12,7]],
start: [7,4]
),