LevelData(tiles: [
 [0,1,1,1,1,1,1,1,1,1,1,1,0,0,0,0,0,0,0]
,[0,1,0,0,0,0,0,1,0,0,0,1,0,0,0,0,0,0,0]
,[0,1,0,0,0,0,0,0,0,0,0,1,0,0,1,1,1,1,1]
,[0,1,0,0,1,0,1,1,0,0,1,1,1,1,1,0,0,0,1]
,[0,1,0,0,0,0,1,1,0,1,0,0,0,1,1,0,0,0,1]
,[0,1,0,0,0,0,1,1,0,1,0,0,0,0,0,0,0,0,1]
,[0,1,0,0,0,0,1,1,0,1,0,0,0,1,1,1,0,1,1]
,[0,1,0,1,1,1,1,1,0,1,1,1,0,0,0,1,0,1,1]
,[0,1,0,0,0,0,1,0,0,0,0,0,0,0,0,1,0,1,1]
,[1,1,0,0,0,0,1,0,0,0,1,1,0,1,1,1,0,0,1]
,[1,0,0,0,0,0,1,0,0,0,1,0,0,0,0,0,0,0,1]
,[1,0,0,0,0,0,1,1,0,0,1,0,0,0,1,1,0,0,1]
,[1,1,0,0,0,1,1,1,1,1,1,0,0,0,1,1,1,1,1]
,[0,1,1,1,1,1,0,0,0,0,1,1,1,1,1,0,0,0,0]
],
boxes: [[12,11],[3,10],[12,10],[16,10],[8,9],[9,8],[2,7],[3,5],[4,5],[5,5],[11,5],[12,5],[17,5],[4,4],[16,4],[8,3],[3,2],[5,2]],
goals: [[2,12],[3,12],[4,12],[2,11],[3,11],[4,11],[5,11],[2,10],[4,10],[5,10],[2,9],[3,9],[4,9],[5,9],[2,8],[3,8],[4,8],[5,8]],
start: [13,5]
),