LevelData(tiles: [
 [0,0,0,0,0,0,0,0,0,0,0,0,0,1,1,1,1,1,0]
,[0,0,0,0,0,0,0,0,0,0,0,0,0,1,0,0,0,1,0]
,[0,0,0,0,0,0,0,1,1,1,1,1,1,1,0,1,0,1,0]
,[0,0,0,1,1,1,1,1,1,0,0,0,0,0,0,0,0,1,0]
,[0,0,0,1,0,0,0,1,1,1,0,0,1,1,0,0,0,1,0]
,[0,0,0,1,0,0,0,0,0,0,0,0,1,1,1,1,0,1,0]
,[1,1,1,1,0,0,1,0,0,1,0,1,1,1,1,1,0,1,0]
,[1,0,0,0,0,0,0,0,1,1,0,1,1,1,1,0,0,1,1]
,[1,0,1,1,0,1,1,0,1,0,0,0,0,0,1,0,0,0,1]
,[1,0,1,0,0,0,1,0,1,0,0,0,0,0,0,0,0,0,1]
,[1,0,0,0,0,0,0,0,1,1,1,0,0,1,1,1,1,1,1]
,[1,0,1,0,0,0,1,0,1,0,1,1,1,1,0,0,0,0,0]
,[1,0,1,1,0,1,1,0,1,0,0,0,0,0,0,0,0,0,0]
,[1,0,0,0,0,0,0,0,1,0,0,0,0,0,0,0,0,0,0]
,[1,1,1,1,1,1,1,1,1,0,0,0,0,0,0,0,0,0,0]
],
boxes: [[12,8],[15,8],[7,7],[5,6],[5,5],[10,5],[11,4],[15,4],[10,3]],
goals: [[3,11],[4,11],[5,11],[3,10],[4,10],[5,10],[3,9],[4,9],[5,9]],
start: [9,3]
),