LevelData(tiles: [
 [0,0,0,0,0,1,1,1,1,1,1,1,1,1,1,0,0,0,0]
,[0,0,1,1,1,1,0,0,0,0,0,0,0,0,1,1,1,1,1]
,[0,0,1,0,0,1,0,0,0,0,0,0,1,0,0,0,0,0,1]
,[1,1,1,0,0,1,1,1,1,0,1,1,1,1,1,1,1,0,1]
,[1,0,0,0,0,1,0,0,1,0,1,1,0,0,0,0,1,0,1]
,[1,0,1,0,0,1,0,0,1,0,0,0,0,0,0,0,1,0,1]
,[1,0,0,0,0,1,0,0,0,0,0,1,0,0,0,0,1,0,1]
,[1,0,1,0,0,0,0,0,1,1,0,1,1,1,0,0,1,0,1]
,[1,0,0,0,0,1,0,0,1,0,0,1,0,0,1,1,1,0,1]
,[1,0,1,0,0,1,1,1,1,0,0,1,0,0,0,0,1,0,1]
,[1,0,0,0,0,1,0,0,0,0,0,0,0,0,0,0,1,0,1]
,[1,0,1,0,0,1,0,0,0,0,0,1,0,0,0,0,0,0,1]
,[1,0,0,0,0,1,0,0,0,0,1,1,1,0,0,1,1,1,1]
,[1,0,0,0,0,1,1,1,0,0,0,0,0,0,0,1,0,0,0]
,[1,1,1,1,1,1,0,1,1,0,0,0,0,0,0,1,0,0,0]
,[0,0,0,0,0,0,0,0,1,1,1,1,1,1,1,1,0,0,0]
],
boxes: [[9,13],[10,13],[13,12],[7,11],[9,11],[13,11],[8,10],[11,10],[15,10],[9,9],[4,8],[4,6],[14,6],[11,5],[14,5],[4,4],[9,3],[8,2]],
goals: [[1,13],[2,13],[3,13],[4,13],[1,12],[2,12],[1,11],[1,10],[2,10],[1,9],[1,8],[2,8],[1,7],[1,6],[2,6],[1,5],[1,4],[2,4]],
start: [4,2]
),