LevelData(tiles: [
 [0,1,1,1,1,1,1,1,1,1,1,1,1,1,1,1,1,1,0]
,[1,1,0,0,0,1,0,0,0,0,1,0,0,0,0,0,0,1,0]
,[1,0,0,1,0,1,0,1,1,0,0,0,0,0,0,0,0,1,1]
,[1,0,0,0,0,1,0,0,0,0,0,1,0,0,0,0,0,0,1]
,[1,0,0,1,0,1,0,0,1,0,0,1,0,0,0,0,0,0,1]
,[1,0,0,0,0,0,0,0,0,0,1,1,1,1,1,1,1,1,1]
,[1,1,0,1,1,0,0,1,1,0,1,0,0,0,0,0,1,0,0]
,[1,0,0,0,0,0,0,1,0,0,0,0,0,0,0,0,1,1,0]
,[1,0,0,1,1,0,0,1,0,1,1,1,0,1,1,0,0,1,0]
,[1,0,0,0,0,0,0,0,0,0,0,0,0,0,0,0,0,1,0]
,[1,1,1,1,1,1,0,0,1,1,0,0,0,0,0,0,0,1,0]
,[0,0,0,0,0,1,1,0,0,0,0,1,1,1,1,1,1,1,0]
,[0,0,0,0,0,0,1,1,1,1,1,1,0,0,0,0,0,0,0]
],
boxes: [[7,10],[10,10],[15,10],[3,9],[6,9],[12,9],[13,9],[15,9],[2,8],[5,7],[12,7],[2,6],[6,6],[9,6],[3,5],[5,5],[8,5],[8,3],[2,2],[9,2]],
goals: [[12,4],[13,4],[14,4],[15,4],[16,4],[17,4],[12,3],[13,3],[14,3],[15,3],[16,3],[17,3],[12,2],[13,2],[14,2],[15,2],[16,2],[14,1],[15,1],[16,1]],
start: [8,11]
),