LevelData(tiles: [
 [0,0,0,0,0,0,0,1,1,1,1,1,1,1,0]
,[0,0,0,1,1,1,1,1,0,0,1,0,0,1,0]
,[0,1,1,1,0,0,0,1,0,0,1,0,0,1,1]
,[0,1,0,0,0,0,0,1,0,0,1,0,0,0,1]
,[0,1,0,0,0,0,0,0,0,0,1,0,0,0,1]
,[0,1,0,0,0,0,0,1,0,0,1,0,0,0,1]
,[1,1,1,1,1,1,1,1,0,0,1,0,0,0,1]
,[1,0,0,0,0,0,0,0,0,0,1,0,0,0,1]
,[1,0,0,0,1,0,0,0,0,0,0,0,0,1,1]
,[1,0,0,0,1,1,0,0,0,0,1,0,0,1,1]
,[1,1,0,0,0,0,0,0,1,1,1,1,1,1,0]
,[0,1,1,1,1,1,1,1,1,0,0,0,0,0,0]
],
boxes: [[2,9],[3,9],[6,8],[7,8],[12,8],[2,7],[4,7],[8,6],[11,5],[8,4],[9,4],[12,4],[11,3]],
goals: [[2,5],[4,5],[5,5],[6,5],[4,4],[5,4],[6,4],[4,3],[5,3],[6,3],[4,2],[5,2],[6,2]],
start: [1,9]
),