LevelData(tiles: [
 [1,1,1,1,1,1,1,1,1,1,1,1,1,1,1,1]
,[1,0,0,0,0,0,0,0,0,0,0,0,0,0,0,1]
,[1,0,0,0,0,0,0,0,0,0,0,0,0,0,0,1]
,[1,0,0,0,0,0,0,0,0,0,0,1,1,1,0,1]
,[1,0,0,0,0,0,0,0,0,0,0,1,0,0,0,1]
,[1,0,0,1,1,1,1,1,1,1,1,1,0,0,0,1]
,[1,0,0,0,0,0,0,0,0,0,0,0,0,0,0,1]
,[1,0,0,0,0,0,0,1,1,0,1,1,0,1,1,1]
,[1,0,1,1,1,1,0,1,1,0,1,1,0,0,0,1]
,[1,0,1,1,1,1,0,1,1,0,1,0,0,0,0,1]
,[1,0,0,0,0,0,0,0,0,0,0,0,0,0,0,1]
,[1,1,1,1,1,1,1,1,1,1,1,1,1,1,1,1]
],
boxes: [[9,10],[6,9],[9,8],[2,5],[2,4],[4,4],[6,4],[8,4],[3,3],[5,3],[7,3],[9,3],[4,2],[6,2],[8,2],[10,2]],
goals: [[12,10],[13,10],[14,10],[12,9],[13,9],[14,9],[12,8],[13,8],[14,8],[12,7],[12,6],[13,6],[14,6],[14,5],[12,4],[14,4]],
start: [1,10]
),