LevelData(tiles: [
 [0,0,0,0,0,0,0,0,0,0,0,0,1,1,1,1,0,0]
,[0,0,0,0,1,1,1,1,1,1,1,1,1,0,0,1,0,0]
,[0,0,0,0,1,0,0,0,1,0,0,1,1,0,0,1,1,0]
,[0,1,1,1,1,0,0,0,0,0,0,0,1,0,0,0,1,0]
,[1,1,0,0,1,0,0,0,0,1,0,0,0,0,0,0,1,0]
,[1,0,0,0,0,0,0,0,0,1,0,1,1,0,0,0,1,1]
,[1,0,0,0,0,0,0,0,0,1,0,1,0,0,0,0,0,1]
,[1,1,1,1,0,1,1,0,0,0,0,0,0,0,0,0,0,1]
,[0,0,0,1,0,0,1,0,0,1,0,1,0,0,0,0,0,1]
,[0,0,0,1,0,0,1,1,1,0,0,1,1,1,0,0,1,1]
,[0,0,0,1,0,0,0,0,0,0,0,0,0,1,0,0,1,0]
,[0,0,0,1,1,1,1,0,0,0,0,0,0,1,1,1,1,0]
,[0,0,0,0,0,0,1,1,1,1,0,0,0,0,1,0,0,0]
,[0,0,0,0,0,0,0,0,0,1,1,0,0,0,1,0,0,0]
,[0,0,0,0,0,0,0,0,0,0,1,0,0,0,1,0,0,0]
,[0,0,0,0,0,0,0,0,0,0,1,1,1,1,1,0,0,0]
],
boxes: [[5,9],[10,8],[13,8],[15,8],[7,7],[10,7],[15,7],[3,6],[4,6],[5,6],[6,5],[8,5],[13,5],[5,4],[7,4],[12,4],[15,4],[8,3],[10,3],[13,3]],
goals: [[11,14],[12,14],[13,14],[11,13],[12,13],[13,13],[10,12],[11,12],[12,12],[13,12],[7,11],[8,11],[9,11],[10,11],[11,11],[12,11],[9,10],[10,10],[11,10],[12,10]],
start: [9,3]
),