LevelData(tiles: [
 [0,0,0,0,1,1,1,1,0,0,0,0,0,0,1,1,1,1,1]
,[1,1,1,1,1,0,0,1,1,1,1,1,1,1,0,0,0,0,1]
,[1,0,0,0,1,0,0,0,0,0,1,0,0,1,0,0,0,0,1]
,[1,0,0,0,0,0,0,1,0,0,0,0,0,0,0,0,0,0,1]
,[1,0,0,0,0,0,0,1,0,0,1,0,0,0,0,0,0,1,1]
,[1,1,0,1,1,1,1,1,1,1,1,1,1,1,0,0,0,0,1]
,[0,1,0,0,1,0,0,0,0,0,0,0,1,0,0,0,1,0,1]
,[0,1,0,0,1,0,0,0,0,0,0,0,1,0,0,1,1,0,1]
,[0,1,0,0,0,0,0,0,0,0,0,0,0,0,0,0,1,0,1]
,[0,1,0,0,1,0,0,0,0,0,0,0,1,0,0,0,1,0,1]
,[0,1,0,0,1,1,1,1,0,1,1,1,1,0,0,0,0,0,1]
,[1,1,0,0,0,0,0,0,0,0,1,1,1,0,0,0,0,0,1]
,[1,0,0,0,0,0,0,0,0,0,0,0,0,0,0,0,0,0,1]
,[1,0,1,1,1,1,1,0,0,0,1,1,1,1,1,1,0,1,1]
,[1,0,0,0,0,0,0,0,1,0,0,0,0,0,0,0,0,0,1]
,[1,1,1,1,1,1,1,1,1,1,1,1,1,1,1,1,1,1,1]
],
boxes: [[8,13],[5,12],[8,12],[10,12],[16,12],[4,11],[8,11],[16,11],[2,10],[8,10],[13,10],[15,10],[14,9],[3,8],[12,8],[2,6],[15,5],[5,4],[14,4],[16,4],[3,3],[5,3],[9,3],[12,3],[15,3],[7,2],[14,2]],
goals: [[5,9],[6,9],[8,9],[9,9],[10,9],[11,9],[4,8],[5,8],[6,8],[8,8],[9,8],[10,8],[11,8],[5,7],[6,7],[7,7],[8,7],[9,7],[10,7],[5,6],[6,6],[7,6],[8,6],[9,6],[10,6],[11,6]],
start: [8,4]
),