LevelData(tiles: [
 [0,0,0,1,1,1,1,1,1,1,1,1,1,0,0,0]
,[0,0,0,1,0,0,0,1,0,0,0,0,1,0,0,0]
,[0,0,0,1,0,0,0,0,0,0,0,0,1,0,0,0]
,[0,1,1,1,1,0,0,1,0,0,0,0,1,0,0,0]
,[1,1,0,0,1,0,0,1,1,1,1,1,1,1,0,0]
,[1,0,0,0,0,0,0,0,0,0,0,0,0,1,0,0]
,[1,0,0,1,0,0,1,1,0,0,1,0,0,1,0,0]
,[1,1,0,1,1,1,1,0,0,1,1,0,1,1,1,1]
,[1,0,0,1,0,1,1,1,1,1,0,0,0,0,0,1]
,[1,0,0,0,0,1,0,0,0,0,0,0,0,1,0,1]
,[1,1,0,0,0,1,0,0,0,0,0,0,0,0,0,1]
,[0,1,1,1,1,1,1,1,0,1,1,0,1,1,1,1]
,[0,0,0,0,0,0,0,1,0,0,0,0,1,0,0,0]
,[0,0,0,0,0,0,0,1,1,1,1,1,1,0,0,0]
],
boxes: [[9,10],[12,10],[3,9],[8,9],[11,9],[12,8]],
goals: [[10,3],[11,3],[10,2],[11,2],[10,1],[11,1]],
start: [13,10]
),