LevelData(tiles: [
 [0,0,0,0,0,0,0,0,0,0,1,1,1,1,1,0,0,0,0]
,[0,0,0,0,0,0,0,0,0,0,1,0,0,0,1,0,0,0,0]
,[0,0,0,0,0,0,0,0,0,0,1,0,0,0,1,0,0,0,0]
,[0,0,0,0,0,0,0,0,0,1,1,0,0,0,1,1,1,0,0]
,[0,0,0,0,0,0,0,0,0,1,0,0,0,0,0,0,1,0,0]
,[1,1,1,1,1,1,0,0,0,1,0,1,1,0,1,0,1,1,1]
,[1,0,0,0,0,1,1,1,1,1,0,1,1,0,1,0,0,0,1]
,[1,0,0,0,0,0,0,0,0,0,0,0,0,0,0,0,0,0,1]
,[1,0,0,0,0,1,1,0,1,0,1,1,1,0,1,1,1,1,1]
,[1,1,1,1,1,1,1,1,1,0,0,0,0,0,1,0,0,0,0]
,[0,0,0,0,0,0,0,0,1,1,1,1,1,1,1,0,0,0,0]
],
boxes: [[13,7],[16,7],[11,4],[13,4],[11,3],[13,2]],
goals: [[1,8],[2,8],[1,7],[2,7],[1,6],[2,6]],
start: [7,8]
),