LevelData(tiles: [
 [1,1,1,1,1,1,1,0,0,0,0,0,0,0,0,0,0]
,[1,0,0,0,0,0,1,0,0,0,0,0,0,0,0,0,0]
,[1,0,0,0,0,0,1,1,1,1,1,0,0,0,0,0,0]
,[1,0,0,0,0,0,0,0,0,0,1,0,0,0,0,0,0]
,[1,0,0,0,0,0,1,1,0,0,1,0,0,0,0,0,0]
,[1,0,0,0,0,0,1,1,0,1,1,0,0,0,0,0,0]
,[1,1,1,1,1,1,1,1,0,1,1,1,0,0,0,0,0]
,[0,0,0,0,1,1,0,0,0,0,0,1,0,0,0,0,0]
,[1,1,1,1,1,0,0,0,0,0,0,1,1,1,1,1,0]
,[1,0,0,0,1,0,0,0,0,0,0,1,0,0,0,1,1]
,[1,0,0,0,0,0,0,0,0,0,0,0,0,0,0,0,1]
,[1,1,1,1,1,0,0,0,0,0,0,1,1,1,1,1,1]
,[0,0,0,0,1,0,0,0,0,0,0,1,0,0,0,0,0]
,[0,0,0,0,1,1,1,1,1,1,1,1,0,0,0,0,0]
],
boxes: [[6,11],[8,11],[9,11],[2,10],[5,10],[10,10],[13,10],[8,9],[10,9],[6,8],[8,8],[7,7],[8,7],[9,7]],
goals: [[1,5],[2,5],[3,5],[1,4],[2,4],[3,4],[1,3],[3,3],[1,2],[2,2],[3,2],[1,1],[2,1],[3,1]],
start: [15,10]
),