LevelData(tiles: [
 [0,1,1,1,1,0,0,0,0,0,0]
,[0,1,0,0,1,1,1,1,1,1,1]
,[0,1,0,0,0,0,0,0,0,0,1]
,[0,1,0,0,1,1,0,0,0,0,1]
,[0,1,0,1,0,0,0,1,0,1,1]
,[0,1,0,0,0,0,0,0,0,1,0]
,[1,1,0,1,0,0,0,1,0,1,0]
,[1,0,0,1,0,1,0,0,0,1,0]
,[1,0,0,0,0,0,0,0,0,1,0]
,[1,1,1,1,1,1,1,0,0,1,0]
,[0,0,0,0,0,0,1,1,1,1,0]
],
boxes: [[5,8],[8,8],[2,7],[7,5],[8,4],[2,3],[6,3],[4,2]],
goals: [[4,6],[6,6],[4,5],[5,5],[6,5],[4,4],[5,4],[6,4]],
start: [2,1]
),