LevelData(tiles: [
 [0,0,0,0,1,1,1,1,1,1,1,0,0,0,0,0,0,0]
,[0,0,0,0,1,0,0,0,0,0,1,1,1,1,1,1,1,0]
,[0,0,0,0,1,0,0,0,0,0,1,0,0,0,0,0,1,0]
,[1,1,1,1,1,1,1,1,1,0,0,0,1,0,0,0,1,0]
,[1,0,0,0,1,1,0,0,0,0,0,0,1,1,1,0,1,0]
,[1,0,1,0,1,1,0,0,0,0,0,0,0,0,0,0,1,0]
,[1,0,0,0,0,0,0,0,0,0,0,0,1,1,1,0,1,0]
,[1,1,0,1,0,1,1,1,0,1,1,1,1,0,0,0,1,1]
,[0,1,0,1,0,0,0,0,0,1,0,0,0,0,1,0,0,1]
,[0,1,0,1,1,0,0,1,0,0,0,0,0,0,0,0,0,1]
,[0,1,0,1,0,0,0,1,1,1,0,0,0,0,0,0,0,1]
,[0,1,0,1,0,0,0,0,0,0,0,0,0,1,1,1,1,1]
,[0,1,0,1,0,0,0,1,1,1,0,1,1,1,0,0,0,0]
,[0,1,0,0,0,1,0,0,0,0,0,1,0,0,0,0,0,0]
,[0,1,0,0,1,1,1,1,1,1,1,1,0,0,0,0,0,0]
,[0,1,1,1,1,0,0,0,0,0,0,0,0,0,0,0,0,0]
],
boxes: [[7,11],[5,10],[6,10],[11,10],[13,10],[5,9],[10,9],[11,9],[12,9],[14,9],[6,8],[13,8],[2,7],[12,5],[14,3],[15,3],[6,2],[8,2]],
goals: [[6,6],[7,6],[8,6],[9,6],[10,6],[11,6],[6,5],[7,5],[8,5],[9,5],[10,5],[11,5],[6,4],[7,4],[8,4],[9,4],[10,4],[11,4]],
start: [7,2]
),