LevelData(tiles: [
 [0,0,0,0,0,0,1,1,1,1,0,1,1,1,1,1]
,[0,0,0,1,1,1,1,0,0,1,0,1,0,0,0,1]
,[0,0,0,1,0,0,0,0,0,1,1,1,0,0,0,1]
,[0,1,1,1,0,0,0,0,0,1,1,0,0,0,0,1]
,[0,1,0,0,0,0,0,0,1,1,0,0,0,0,1,1]
,[0,1,0,0,0,0,0,1,1,0,0,0,0,1,1,1]
,[0,1,0,0,0,0,0,1,0,0,0,0,1,1,0,1]
,[1,1,1,1,0,1,1,1,0,1,0,1,1,0,0,1]
,[1,0,0,0,0,0,0,0,0,1,0,1,0,0,0,1]
,[1,0,0,0,0,0,0,0,0,0,0,0,0,0,0,1]
,[1,1,1,0,0,0,0,0,0,0,0,1,0,0,0,1]
,[0,0,1,1,1,0,0,1,1,1,1,1,1,0,0,1]
,[0,0,0,0,1,1,1,1,0,0,0,0,1,1,0,1]
,[0,0,0,0,0,0,0,0,0,0,0,0,0,1,1,1]
],
boxes: [[4,10],[6,10],[7,10],[9,10],[3,9],[8,9],[12,9],[5,8],[8,8],[13,8],[4,6],[3,5],[5,5],[4,4],[4,3],[7,3],[6,2]],
goals: [[10,5],[11,5],[12,5],[10,4],[11,4],[12,4],[13,4],[11,3],[12,3],[13,3],[14,3],[12,2],[13,2],[14,2],[12,1],[13,1],[14,1]],
start: [10,9]
),