LevelData(tiles: [
 [1,1,1,1,1,1,0,0,0,0,0,0,0,0,0,0,0,0,0]
,[1,0,0,0,0,1,1,1,1,1,1,1,1,1,1,1,1,1,0]
,[1,0,0,0,0,1,1,0,0,0,0,0,1,1,0,0,0,1,1]
,[1,0,0,0,0,1,1,0,0,0,0,0,1,1,0,0,0,0,1]
,[1,0,0,0,0,0,0,1,0,0,0,0,0,0,0,0,0,0,1]
,[1,0,0,0,0,0,0,1,0,0,0,0,1,1,0,0,0,0,1]
,[1,0,0,0,0,0,0,1,0,0,0,0,1,1,0,0,0,0,1]
,[1,1,1,0,1,1,0,1,1,1,0,1,1,1,1,1,0,1,1]
,[1,0,0,0,0,0,0,1,1,0,0,0,0,0,0,0,0,1,1]
,[1,1,1,0,1,1,1,1,1,0,1,0,0,1,1,1,0,0,1]
,[0,0,1,0,0,0,0,0,0,0,1,0,0,0,0,0,0,0,1]
,[0,0,1,0,0,1,1,1,0,0,0,0,0,1,0,0,0,0,1]
,[0,0,1,1,1,1,0,1,0,0,0,0,0,1,0,0,0,0,1]
,[0,0,0,0,0,0,0,1,0,0,0,0,0,1,0,0,0,0,1]
,[0,0,0,0,0,0,0,1,1,1,0,0,0,1,1,1,1,1,1]
,[0,0,0,0,0,0,0,0,0,1,1,1,1,1,0,0,0,0,0]
],
boxes: [[9,13],[10,13],[11,12],[14,12],[15,12],[16,12],[8,11],[10,11],[12,11],[15,11],[14,10],[16,9],[10,8],[13,8],[10,6],[15,6],[9,5],[10,5],[11,5],[15,5],[8,4],[10,4],[9,3],[14,3],[15,3]],
goals: [[3,8],[3,7],[1,6],[2,6],[3,6],[4,6],[1,5],[2,5],[3,5],[1,4],[2,4],[3,4],[4,4],[1,3],[2,3],[3,3],[4,3],[1,2],[2,2],[3,2],[4,2],[1,1],[2,1],[3,1],[4,1]],
start: [7,3]
),