LevelData(tiles: [
 [0,0,1,1,1,1,1,1,1,1,1,1,1,1]
,[1,1,1,0,0,0,0,0,1,0,0,0,0,1]
,[1,0,0,0,0,0,0,0,1,0,0,0,0,1]
,[1,0,0,1,1,1,1,0,1,0,0,0,0,1]
,[1,0,0,1,1,0,0,0,0,0,0,0,0,1]
,[1,1,0,0,0,0,1,0,1,0,0,0,0,1]
,[1,0,0,0,0,1,1,0,1,1,1,1,1,1]
,[1,0,0,0,0,0,0,0,0,0,0,1,0,0]
,[1,0,0,0,0,0,1,0,0,0,0,1,0,0]
,[1,1,1,1,1,1,1,1,1,1,1,1,0,0]
],
boxes: [[2,7],[4,7],[6,7],[9,7],[2,6],[4,6],[3,5],[7,3],[3,2],[6,2]],
goals: [[11,5],[12,5],[11,4],[12,4],[11,3],[12,3],[11,2],[12,2],[11,1],[12,1]],
start: [6,4]
),