LevelData(tiles: [
 [0,0,0,1,1,1,1,0,0,0,0,0,0]
,[0,0,0,1,0,0,1,1,1,1,1,0,0]
,[0,0,0,1,0,0,0,0,0,0,1,1,0]
,[0,1,1,1,0,1,1,0,0,0,0,1,1]
,[0,1,0,0,0,0,1,0,0,0,0,0,1]
,[0,1,0,0,0,0,1,1,0,1,1,1,1]
,[0,1,0,0,0,0,1,0,0,0,0,1,0]
,[0,1,0,0,0,0,1,0,0,0,0,1,0]
,[1,1,0,0,0,0,0,0,0,0,0,1,0]
,[1,0,0,0,0,0,1,0,0,0,0,1,0]
,[1,0,0,0,0,0,1,1,1,1,1,1,0]
,[1,1,1,0,0,0,1,0,0,0,0,0,0]
,[0,1,1,1,0,0,1,0,0,0,0,0,0]
,[0,0,0,1,0,0,1,0,0,0,0,0,0]
,[0,0,0,1,1,1,1,0,0,0,0,0,0]
],
boxes: [[5,12],[3,10],[5,10],[4,9],[3,8],[4,8],[2,7],[3,6],[5,6],[2,5],[4,4],[8,4],[10,4],[9,3],[4,2]],
goals: [[8,9],[9,9],[10,9],[7,8],[8,8],[9,8],[10,8],[7,7],[8,7],[9,7],[10,7],[7,6],[8,6],[9,6],[10,6]],
start: [11,4]
),