LevelData(tiles: [
 [0,0,0,0,1,1,1,1,1,1,1,1,1,0]
,[0,0,0,1,1,0,0,0,0,0,0,0,1,0]
,[0,0,1,1,0,0,0,0,1,0,1,0,1,0]
,[0,1,1,0,0,1,0,1,0,0,0,0,1,1]
,[1,1,0,0,1,0,0,1,0,0,0,0,0,1]
,[1,0,0,1,1,0,0,1,0,0,0,0,0,1]
,[1,0,0,0,0,0,0,0,1,1,1,0,1,1]
,[1,0,0,1,0,0,0,0,0,0,0,0,1,0]
,[1,0,1,1,0,0,0,0,0,0,1,0,1,0]
,[1,0,0,1,1,0,0,1,1,1,0,0,1,0]
,[1,1,0,1,1,0,1,1,0,0,0,0,1,0]
,[0,1,0,0,0,0,0,1,0,0,0,0,1,0]
,[0,1,1,1,0,0,0,0,0,0,1,1,1,0]
,[0,0,0,1,1,1,1,1,0,0,1,0,0,0]
,[0,0,0,0,0,0,0,1,1,1,1,0,0,0]
],
boxes: [[7,12],[9,12],[4,11],[9,11],[5,8],[7,8],[4,7],[6,7],[8,7],[11,7],[5,6],[2,5],[6,5],[5,2]],
goals: [[8,4],[9,4],[10,4],[11,4],[8,3],[9,3],[10,3],[11,3],[9,2],[11,2],[8,1],[9,1],[10,1],[11,1]],
start: [3,3]
),