LevelData(tiles: [
 [0,1,1,1,1,1,0,0,0,0,0,0,0,0,0,0]
,[0,1,0,0,0,1,1,1,1,1,1,1,1,1,0,0]
,[0,1,0,0,0,0,0,0,0,0,0,0,0,1,1,1]
,[1,1,1,0,1,1,1,1,1,1,1,0,0,0,0,1]
,[1,0,0,0,1,0,0,0,0,0,1,0,0,0,0,1]
,[1,0,1,0,0,0,1,0,0,0,0,0,0,0,0,1]
,[1,0,1,0,1,0,0,0,0,0,1,0,1,1,1,1]
,[1,0,1,0,1,1,1,1,1,1,1,0,1,0,0,0]
,[1,0,0,0,0,0,0,0,0,0,0,0,1,0,0,0]
,[1,1,1,1,1,1,1,1,1,1,0,0,1,0,0,0]
,[0,0,0,0,0,0,0,0,0,1,1,1,1,0,0,0]
],
boxes: [[7,8],[3,5],[12,5],[3,3],[12,3],[13,3],[7,2]],
goals: [[5,6],[9,6],[7,5],[8,5],[9,5],[5,4],[9,4]],
start: [2,8]
),