LevelData(tiles: [
 [0,1,1,1,1,1,1,1,1,1,1,1,1,1,1,1,1]
,[0,1,0,0,0,0,0,0,0,0,0,0,0,0,0,0,1]
,[0,1,0,0,0,0,0,1,1,1,1,1,1,0,1,0,1]
,[0,1,0,0,1,0,0,0,0,0,0,0,0,0,1,0,1]
,[1,1,0,1,1,0,0,0,0,0,0,0,0,0,1,0,1]
,[1,0,0,0,1,1,1,0,0,0,0,0,1,0,1,0,1]
,[1,0,0,0,1,1,0,0,0,0,0,0,0,0,1,0,1]
,[1,0,0,0,1,1,0,0,0,0,0,0,1,1,1,0,1]
,[1,0,0,0,1,1,0,1,1,0,1,0,0,0,0,0,1]
,[1,0,0,0,1,1,0,1,1,0,0,0,1,1,1,1,1]
,[1,1,1,0,0,0,0,0,1,1,1,1,1,0,0,0,0]
,[0,0,1,0,0,0,0,0,1,0,0,0,0,0,0,0,0]
,[0,0,1,1,1,1,1,1,1,0,0,0,0,0,0,0,0]
],
boxes: [[7,7],[9,7],[10,7],[11,7],[8,6],[10,6],[7,5],[9,5],[11,5],[8,4],[10,4],[5,3],[7,3],[9,3],[11,3]],
goals: [[1,9],[2,9],[3,9],[1,8],[2,8],[3,8],[1,7],[2,7],[3,7],[1,6],[2,6],[3,6],[1,5],[2,5],[3,5]],
start: [9,4]
),