LevelData(tiles: [
 [1,1,1,1,1,1,0,1,1,1,1,1,1,1,1,1,1,1,1]
,[1,0,0,0,0,1,1,1,0,1,0,0,0,0,1,0,0,0,1]
,[1,0,0,0,0,0,0,0,0,0,0,0,1,0,0,0,0,0,1]
,[1,0,0,0,0,0,1,0,0,0,1,1,1,0,1,0,0,0,1]
,[1,0,0,0,0,0,0,1,0,0,1,1,1,0,1,1,0,1,1]
,[1,1,1,1,0,1,0,1,0,0,0,0,0,0,0,0,0,1,0]
,[1,0,0,0,0,0,0,1,0,0,1,1,0,0,0,0,0,1,0]
,[1,0,0,0,0,1,0,1,1,1,1,0,0,1,0,1,1,1,1]
,[1,0,0,0,0,1,0,1,1,0,0,0,0,1,0,1,0,0,1]
,[1,1,0,0,0,1,0,1,1,0,1,0,0,0,0,0,0,0,1]
,[0,1,0,0,0,1,0,1,0,0,0,0,0,0,0,0,1,0,1]
,[0,1,1,1,1,1,0,1,0,1,1,0,1,1,0,0,0,0,1]
,[0,0,0,0,0,1,0,0,0,0,0,0,0,0,0,0,0,0,1]
,[0,0,0,0,0,1,0,0,0,0,1,1,1,0,1,1,0,1,0]
,[0,0,0,0,0,1,0,0,0,0,1,0,1,0,0,0,0,1,0]
,[0,0,0,0,0,1,1,1,1,1,1,0,1,1,1,1,1,1,0]
],
boxes: [[8,13],[8,12],[9,12],[15,12],[16,12],[15,11],[12,10],[14,10],[13,9],[16,9],[12,8],[12,6],[14,6],[13,5],[15,5],[13,2],[14,2]],
goals: [[1,4],[2,4],[3,4],[4,4],[1,3],[2,3],[3,3],[4,3],[1,2],[2,2],[3,2],[4,2],[5,2],[1,1],[2,1],[3,1],[4,1]],
start: [8,2]
),