LevelData(tiles: [
 [0,1,1,1,1,1,0,0,0,0,0,0,0]
,[1,1,0,0,0,1,1,1,1,1,1,1,0]
,[1,0,0,0,0,1,1,0,0,1,0,1,1]
,[1,0,0,0,0,0,0,0,0,0,0,0,1]
,[1,0,0,0,1,1,1,0,0,0,0,0,1]
,[1,1,1,0,1,1,1,1,1,0,1,1,1]
,[0,1,0,0,0,1,1,1,0,0,0,0,1]
,[0,1,0,0,0,0,0,0,0,0,0,0,1]
,[0,1,0,0,0,1,1,1,0,0,0,0,1]
,[0,1,0,0,0,1,0,1,0,0,0,0,1]
,[0,1,1,1,1,1,0,1,1,1,0,0,1]
,[0,0,0,0,0,0,0,0,0,1,1,1,1]
],
boxes: [[9,9],[10,9],[6,7],[8,7],[10,7],[10,6],[3,5],[9,4],[7,3],[2,2],[3,2]],
goals: [[2,9],[3,9],[4,9],[2,8],[3,8],[4,8],[2,7],[3,7],[4,7],[2,6],[3,6]],
start: [7,2]
),