LevelData(tiles: [
 [0,0,0,1,1,1,1,1,1,1,1,1,1,1,0,0,0,0,0]
,[0,0,0,1,0,0,0,1,0,0,0,0,0,1,0,0,0,0,0]
,[0,0,0,1,0,0,0,0,0,0,0,1,0,1,0,0,0,0,0]
,[0,0,1,1,1,1,0,1,0,0,1,1,0,1,1,1,1,1,0]
,[1,1,1,0,0,0,0,0,1,1,1,0,0,0,1,0,0,1,1]
,[1,0,0,0,0,1,0,0,0,0,0,0,0,0,1,0,0,0,1]
,[1,0,1,1,0,1,1,0,0,1,1,0,0,0,0,0,0,0,1]
,[1,0,1,0,0,0,1,0,0,0,1,0,1,1,0,1,1,1,1]
,[1,0,1,0,0,0,0,0,1,0,0,0,0,1,0,1,1,0,0]
,[1,0,1,1,0,0,1,0,0,1,0,1,0,0,0,0,1,0,0]
,[1,0,0,0,0,0,0,0,0,0,0,0,0,0,0,0,1,0,0]
,[1,0,0,1,1,1,1,1,1,1,1,1,1,1,0,0,1,0,0]
,[1,1,1,1,0,0,0,0,0,0,0,0,0,1,1,1,1,0,0]
],
boxes: [[4,9],[13,9],[4,8],[5,8],[7,8],[8,7],[11,7],[14,7],[2,5],[7,5],[16,5]],
goals: [[12,6],[13,6],[11,5],[12,5],[13,5],[11,4],[12,4],[8,3],[9,3],[10,2],[10,1]],
start: [5,2]
),