LevelData(tiles: [
 [0,0,0,0,0,0,0,0,0,0,0,0,1,1,1,1,1,1,1]
,[0,0,0,1,1,1,1,1,1,1,1,1,1,0,0,0,0,0,1]
,[0,0,0,1,0,0,0,0,0,0,0,0,0,0,0,0,0,0,1]
,[0,0,0,1,0,0,0,0,0,0,0,0,0,0,0,0,0,1,1]
,[1,1,1,1,1,1,0,1,1,1,1,0,0,0,0,1,0,0,1]
,[1,0,0,0,0,0,0,0,0,0,0,0,0,0,0,1,0,0,1]
,[1,0,0,0,1,0,0,1,1,1,1,1,1,0,0,1,0,0,1]
,[1,0,0,0,1,0,0,0,0,0,0,1,1,0,0,1,0,0,1]
,[1,1,1,1,1,1,0,1,1,0,0,0,0,0,0,1,1,1,1]
,[0,1,0,0,0,0,0,0,1,0,0,0,0,0,0,0,1,0,0]
,[0,1,0,0,0,0,0,0,1,1,1,1,0,0,0,0,1,0,0]
,[0,1,0,0,0,0,0,0,1,0,0,0,0,0,0,0,1,0,0]
,[0,1,0,0,0,0,0,0,1,1,1,1,1,1,1,1,1,0,0]
,[0,1,1,1,1,1,1,1,1,0,0,0,0,0,0,0,0,0,0]
],
boxes: [[10,8],[12,8],[13,7],[2,6],[5,6],[3,5],[13,5],[14,4],[16,4],[7,3],[10,3],[15,3],[5,2],[9,2],[12,2],[14,2],[15,2]],
goals: [[2,12],[3,12],[4,12],[5,12],[6,12],[7,12],[2,11],[3,11],[4,11],[5,11],[6,11],[7,11],[2,10],[3,10],[4,10],[5,10],[6,10]],
start: [10,5]
),