LevelData(tiles: [
 [0,0,0,0,0,0,0,0,1,1,1,1,1,1,1,0,0,0,0]
,[0,0,0,0,0,1,1,1,1,0,0,1,0,0,1,0,0,0,0]
,[0,0,0,0,1,1,0,0,1,0,0,1,0,0,1,1,1,1,1]
,[0,0,0,0,1,0,0,0,1,0,0,1,0,0,1,0,0,0,1]
,[0,1,1,1,1,0,0,0,1,0,0,1,0,0,1,0,0,0,1]
,[0,1,0,0,1,0,0,0,1,0,0,0,0,0,1,0,0,0,1]
,[0,1,0,0,0,0,0,0,1,0,0,1,0,0,0,0,0,0,1]
,[0,1,0,0,1,0,0,0,1,0,0,1,0,0,1,0,0,0,1]
,[0,1,0,0,1,0,0,0,0,0,0,1,0,0,1,0,0,0,1]
,[1,1,0,0,1,0,0,0,1,0,0,1,0,0,1,0,0,0,1]
,[1,0,0,0,1,0,0,0,1,0,0,1,0,0,1,0,0,0,1]
,[1,0,0,0,1,0,0,0,1,0,0,1,0,0,1,0,0,0,1]
,[1,0,0,0,1,1,1,1,1,0,0,1,1,1,1,0,0,1,1]
,[1,1,1,1,1,0,0,0,1,1,1,1,0,0,1,1,1,1,0]
],
boxes: [[3,10],[5,10],[12,10],[7,9],[9,9],[10,9],[5,8],[12,8],[7,7],[10,7],[6,6],[12,6],[7,5],[5,4],[10,4],[12,4],[10,2],[12,2]],
goals: [[16,12],[16,11],[17,11],[16,10],[17,10],[16,9],[17,9],[16,8],[17,8],[16,7],[17,7],[16,6],[17,6],[17,5],[16,4],[17,4],[16,3],[17,3]],
start: [15,7]
),