LevelData(tiles: [
 [0,0,1,1,1,1,1,0,0,0,0,0,0,0,0,0,0,0,0]
,[0,0,1,0,0,0,1,1,1,1,1,1,0,0,1,1,1,1,1]
,[0,0,1,0,0,0,0,0,0,0,0,1,1,1,1,0,0,0,1]
,[0,1,1,0,0,1,1,0,1,1,0,1,1,0,0,0,0,0,1]
,[0,1,0,0,0,0,0,0,0,0,0,0,0,0,0,0,0,0,1]
,[1,1,0,0,0,0,0,1,1,0,1,1,0,0,0,0,1,1,1]
,[1,0,0,0,1,1,1,1,1,0,1,1,1,1,1,0,1,0,0]
,[1,0,0,0,0,0,1,1,0,0,1,1,1,1,1,0,1,1,0]
,[1,1,0,0,0,0,1,1,1,0,1,1,1,0,0,0,0,1,0]
,[0,1,1,1,0,0,1,1,1,0,0,0,1,0,0,0,0,1,0]
,[0,0,0,1,0,0,0,0,0,0,1,0,0,0,0,0,0,1,0]
,[0,0,0,1,0,0,1,1,0,0,0,1,0,0,0,0,0,1,0]
,[0,0,0,0,1,1,1,0,0,0,0,1,1,1,1,1,1,1,0]
,[0,0,0,0,1,0,0,0,0,0,0,0,0,0,1,0,0,0,0]
,[0,0,0,0,1,0,0,0,0,0,0,0,0,0,1,0,0,0,0]
,[0,0,0,0,1,1,1,1,1,1,1,1,1,1,1,0,0,0,0]
],
boxes: [[5,10],[6,10],[12,10],[14,10],[15,10],[15,9],[4,8],[9,8],[15,8],[15,7],[2,6],[3,6],[14,5],[3,4],[6,4],[12,4],[14,4],[16,3],[4,2],[6,2],[8,2]],
goals: [[5,14],[6,14],[7,14],[8,14],[9,14],[10,14],[11,14],[12,14],[13,14],[5,13],[6,13],[7,13],[8,13],[9,13],[10,13],[11,13],[12,13],[13,13],[7,12],[9,12],[10,12]],
start: [8,7]
),