LevelData(tiles: [
 [0,0,0,0,0,0,1,1,1,1,1,1,1,1,1]
,[0,0,0,0,0,0,1,0,0,0,0,0,0,0,1]
,[0,0,0,1,1,1,1,0,0,0,0,0,0,0,1]
,[0,0,0,1,0,0,1,0,1,1,1,1,0,1,1]
,[0,0,0,1,0,0,0,0,1,1,0,1,0,1,1]
,[0,0,0,1,0,0,0,0,0,0,0,0,0,0,1]
,[0,0,0,1,0,0,0,0,1,1,0,1,0,0,1]
,[1,1,1,1,0,0,0,0,1,1,0,1,0,0,1]
,[1,0,0,1,0,0,0,0,0,0,0,1,1,1,1]
,[1,0,0,0,0,0,0,0,1,1,0,0,0,1,0]
,[1,0,0,0,0,1,0,1,0,0,0,1,0,1,0]
,[1,0,0,0,1,1,0,1,0,1,0,0,0,1,0]
,[1,0,0,0,1,0,0,0,0,1,1,1,1,1,0]
,[1,1,1,1,1,0,0,0,1,1,0,0,0,0,0]
,[0,0,0,0,1,1,1,1,1,0,0,0,0,0,0]
],
boxes: [[7,12],[4,8],[6,8],[7,8],[8,8],[5,7],[6,6],[4,5],[5,5],[8,5],[10,5],[11,5],[12,5]],
goals: [[1,12],[2,12],[3,12],[1,11],[2,11],[3,11],[1,10],[3,10],[4,10],[1,9],[2,9],[3,9],[4,9]],
start: [10,4]
),