LevelData(tiles: [
 [0,0,0,0,0,1,1,1,1,0,0,0,0,0,0,0,0,0,0]
,[0,0,0,0,0,1,0,0,1,0,1,1,1,1,0,0,0,0,0]
,[0,0,0,0,0,1,0,0,1,1,1,0,0,1,1,1,0,0,0]
,[0,0,0,0,0,1,0,0,0,0,0,0,0,0,0,1,1,0,0]
,[0,0,0,0,0,1,1,0,1,1,0,0,0,0,0,0,1,1,0]
,[0,0,0,0,0,1,0,0,0,0,0,1,1,0,1,0,0,1,0]
,[0,0,0,0,1,1,1,0,1,0,0,0,0,0,0,1,0,1,0]
,[1,1,1,1,1,0,0,0,1,0,0,1,0,0,0,0,0,1,0]
,[1,0,0,0,1,0,0,0,0,0,1,0,0,0,0,1,1,1,1]
,[1,0,0,0,0,0,0,0,0,0,0,0,1,1,0,1,1,1,1]
,[1,1,1,1,1,1,1,1,0,0,1,1,1,0,0,0,0,0,1]
,[0,0,0,0,0,0,0,1,1,1,1,0,1,0,0,0,0,0,1]
,[0,0,0,0,0,0,0,0,0,0,0,0,1,0,1,0,0,0,1]
,[0,0,0,0,0,0,0,0,0,0,0,0,1,0,0,0,0,0,1]
,[0,0,0,0,0,0,0,0,0,0,0,0,1,1,1,1,1,1,1]
],
boxes: [[10,9],[6,8],[7,8],[6,7],[13,7],[10,6],[11,6],[13,6],[13,5],[10,4],[11,4],[13,4],[8,3],[7,2]],
goals: [[13,13],[14,13],[15,13],[16,13],[17,13],[13,12],[15,12],[16,12],[17,12],[13,11],[14,11],[16,11],[17,11],[17,10]],
start: [11,3]
),