LevelData(tiles: [
 [1,1,1,1,1,1,1,1,1,1,1,1]
,[1,0,0,1,1,0,0,0,0,0,1,1]
,[1,0,0,0,0,0,0,0,0,0,1,1]
,[1,0,0,0,0,1,1,0,1,1,1,1]
,[1,0,0,0,0,1,0,0,0,0,0,1]
,[1,1,1,1,0,1,0,0,0,0,0,1]
,[1,1,0,0,0,1,0,1,0,0,0,1]
,[1,0,0,0,0,1,0,0,1,0,0,1]
,[1,0,0,0,0,1,0,0,1,0,0,1]
,[1,1,1,1,0,1,0,0,0,0,0,1]
,[1,0,1,0,0,0,0,0,1,1,1,1]
,[1,0,1,0,0,1,0,0,0,0,0,1]
,[1,0,0,0,0,1,0,0,0,0,1,1]
,[1,0,0,0,0,1,1,0,0,1,1,1]
,[1,1,1,1,1,1,1,1,1,1,1,1]
],
boxes: [[2,12],[3,11],[4,10],[6,8],[9,8],[2,7],[3,6],[7,5],[8,5],[9,5],[7,4],[2,3],[3,3],[2,2],[6,2]],
goals: [[7,13],[8,13],[6,12],[7,12],[8,12],[9,12],[6,11],[7,11],[8,11],[9,11],[10,11],[6,10],[7,10],[6,9],[7,9]],
start: [1,10]
),