LevelData(tiles: [
 [0,0,0,0,1,1,1,1,1,1,1,0,0,0,0,0,0,0,0]
,[0,1,1,1,1,0,0,1,0,0,1,1,1,1,1,0,0,0,0]
,[0,1,0,0,0,0,0,0,0,0,1,0,0,0,1,0,0,0,0]
,[0,1,0,0,1,1,0,1,1,0,0,0,0,0,1,1,1,1,0]
,[1,1,1,0,1,1,0,0,1,0,1,0,0,0,0,0,0,1,1]
,[1,0,0,0,0,0,0,0,0,0,1,0,0,1,1,1,0,0,1]
,[1,0,0,0,1,0,0,1,1,0,1,0,0,0,0,0,0,0,1]
,[1,1,0,1,1,1,0,1,0,0,0,0,0,0,1,0,0,0,1]
,[1,0,0,0,0,0,0,0,0,1,1,1,0,0,1,0,0,0,1]
,[1,0,0,0,0,0,0,0,1,1,0,1,1,1,1,1,1,1,1]
,[1,1,1,1,1,1,1,1,1,0,0,0,0,0,0,0,0,0,0]
],
boxes: [[3,8],[6,8],[3,5],[6,5],[9,5],[11,5],[10,3],[11,3],[6,2]],
goals: [[15,8],[16,8],[17,8],[15,7],[16,7],[17,7],[15,6],[16,6],[17,6]],
start: [9,7]
),