LevelData(tiles: [
 [0,0,0,0,0,0,1,1,1,1,1,1,1,0,0,0,0]
,[0,0,0,0,0,0,1,0,0,1,0,0,0,1,0,0,0]
,[0,0,0,0,0,0,1,0,0,0,0,0,0,1,0,0,0]
,[0,0,0,1,1,1,1,0,0,0,0,1,0,1,1,1,0]
,[0,0,0,1,0,0,0,0,1,1,0,0,0,0,0,1,0]
,[0,0,0,1,0,0,1,0,0,0,0,0,1,0,0,1,0]
,[1,1,1,1,0,0,0,0,0,0,0,0,1,0,0,1,0]
,[1,0,0,0,0,0,1,1,0,1,1,1,1,0,1,1,0]
,[1,0,0,0,1,0,1,0,0,0,0,0,1,0,0,1,0]
,[1,1,1,0,1,0,0,0,0,0,0,0,0,0,0,1,0]
,[0,0,1,0,0,0,1,0,0,0,0,0,1,0,0,1,1]
,[0,0,1,1,1,1,1,1,1,0,1,1,1,0,0,0,1]
,[0,0,0,0,0,0,0,1,0,0,1,0,0,0,0,0,1]
,[0,0,0,0,0,0,0,1,0,0,0,0,0,1,0,0,1]
,[0,0,0,0,0,0,0,1,0,0,0,1,1,1,1,1,1]
,[0,0,0,0,0,0,0,1,1,1,1,1,0,0,0,0,0]
],
boxes: [[13,12],[14,12],[5,9],[12,9],[13,8],[8,7],[5,6],[4,5],[8,5],[7,4],[12,4],[10,3],[10,2]],
goals: [[7,10],[8,10],[9,10],[10,10],[11,10],[7,9],[10,9],[11,9],[7,8],[8,8],[9,8],[10,8],[11,8]],
start: [10,5]
),