LevelData(tiles: [
 [0,0,0,1,1,1,1,1,0,0,0,0,0,0,0,0,0,0,0]
,[0,0,1,1,0,0,0,1,1,0,0,0,0,0,0,0,0,0,0]
,[0,0,1,0,0,0,0,0,1,1,0,0,0,0,0,0,0,0,0]
,[0,0,1,0,0,0,0,0,0,1,1,0,0,0,0,0,0,0,0]
,[0,0,1,0,0,0,0,0,0,0,1,1,0,0,0,0,0,0,0]
,[0,0,1,0,0,0,0,0,0,0,0,1,0,0,0,0,0,0,0]
,[1,1,1,1,1,0,0,0,0,0,0,1,0,0,0,1,1,1,1]
,[1,0,0,0,0,1,1,0,1,1,1,1,1,1,1,1,0,0,1]
,[1,0,0,0,0,0,0,0,0,0,0,0,0,0,0,0,0,0,1]
,[1,1,0,0,0,1,1,0,1,1,1,1,1,1,1,0,1,0,1]
,[1,1,0,0,0,1,0,0,1,1,1,1,1,1,1,0,1,0,1]
,[1,0,0,0,0,1,0,0,0,0,0,0,0,0,0,0,0,0,1]
,[1,0,0,0,0,1,1,1,1,1,1,1,1,1,1,1,1,1,1]
,[1,1,0,0,1,1,0,0,0,0,0,0,0,0,0,0,0,0,0]
,[0,1,1,1,1,0,0,0,0,0,0,0,0,0,0,0,0,0,0]
],
boxes: [[2,12],[2,10],[4,10],[2,8],[3,8],[4,8],[6,6],[7,6],[4,5],[9,5],[4,4],[7,4],[8,4],[5,3],[6,3]],
goals: [[7,11],[8,11],[9,11],[10,11],[11,11],[12,11],[13,11],[14,11],[15,11],[16,11],[17,11],[7,10],[17,10],[17,9],[17,8]],
start: [1,8]
),