LevelData(tiles: [
 [0,0,0,0,0,0,0,0,0,1,1,1,1,1]
,[0,0,0,0,0,0,0,0,1,1,0,0,0,1]
,[0,0,1,1,1,1,0,0,1,0,0,0,0,1]
,[0,0,1,0,0,1,1,1,1,0,0,0,0,1]
,[0,0,1,0,0,0,0,0,0,0,0,0,0,1]
,[0,1,1,0,0,0,0,0,1,0,0,1,1,1]
,[1,1,0,0,0,0,0,0,1,1,0,0,1,0]
,[1,0,0,1,1,0,1,1,0,0,0,0,1,0]
,[1,0,1,0,0,0,1,1,0,1,0,0,1,0]
,[1,0,1,1,0,0,0,0,0,0,1,1,1,0]
,[1,0,0,0,0,0,1,0,0,0,0,1,0,0]
,[1,0,0,0,0,0,1,0,0,0,0,1,0,0]
,[1,1,1,1,1,1,1,1,1,0,0,1,0,0]
,[0,0,0,0,0,0,0,0,1,0,0,1,0,0]
,[0,0,0,0,0,0,0,0,1,1,1,1,0,0]
],
boxes: [[8,11],[9,11],[6,9],[5,8],[8,8],[10,7],[3,6],[5,6],[7,5],[3,4],[7,4],[9,4],[10,4],[11,3]],
goals: [[1,11],[2,11],[3,11],[4,11],[5,11],[1,10],[2,10],[3,10],[5,10],[1,9],[4,9],[5,9],[1,8],[1,7]],
start: [10,5]
),