LevelData(tiles: [
 [0,0,0,0,0,0,0,1,1,1,1,1,1,1,1,0]
,[0,1,1,1,1,1,1,1,0,0,0,0,0,0,1,0]
,[0,1,0,0,0,0,0,0,0,0,0,0,0,0,1,1]
,[0,1,0,0,0,1,1,1,1,0,0,0,0,0,0,1]
,[0,1,0,0,0,0,0,0,0,0,0,0,0,0,1,1]
,[1,1,0,0,0,0,1,1,1,1,1,0,0,0,1,0]
,[1,0,0,0,0,0,1,0,0,0,0,0,0,0,1,0]
,[1,0,0,0,0,0,1,0,0,0,0,0,0,0,1,1]
,[1,1,0,1,1,1,1,0,0,0,1,1,1,1,1,1]
,[1,0,0,0,0,0,1,0,0,0,0,1,0,0,0,1]
,[1,0,0,0,0,0,1,0,0,0,0,0,0,0,0,1]
,[1,0,0,0,0,0,1,0,0,0,0,0,0,0,0,1]
,[1,1,1,1,1,1,1,1,1,1,1,1,1,1,1,1]
],
boxes: [[4,10],[3,9],[2,8],[3,7],[4,6],[3,5],[4,4],[3,3],[4,2]],
goals: [[12,11],[13,11],[14,11],[12,10],[13,10],[14,10],[12,9],[13,9],[14,9]],
start: [14,3]
),