LevelData(tiles: [
 [1,1,1,1,1,1,1,1,0,0,0,0,0,0,0,0,0,0,0]
,[1,0,0,0,0,0,0,1,0,0,0,0,0,0,0,0,0,0,0]
,[1,0,0,0,0,0,0,1,1,1,1,1,1,1,1,1,1,1,1]
,[1,0,0,0,0,0,0,0,0,0,0,0,0,1,0,0,0,0,1]
,[1,0,0,0,0,0,0,1,0,0,0,0,0,1,0,0,0,0,1]
,[1,0,0,0,0,0,0,1,0,0,0,0,0,0,0,0,0,0,1]
,[1,1,1,1,1,1,1,1,0,0,0,0,0,1,0,0,0,0,1]
,[0,0,0,0,0,0,0,1,0,0,0,0,0,1,0,0,0,0,1]
,[0,0,0,0,0,0,0,1,1,1,1,1,1,1,1,1,0,1,1]
,[0,0,0,0,0,0,0,1,1,0,0,0,0,1,0,0,0,0,1]
,[0,0,0,0,0,0,0,1,1,0,0,0,0,0,0,0,0,0,1]
,[0,0,0,0,0,0,0,1,0,0,0,0,0,1,0,0,0,0,1]
,[0,0,0,0,0,0,0,1,1,0,0,0,0,1,0,0,0,0,1]
,[0,0,0,0,0,0,0,0,1,1,1,1,1,1,1,1,1,1,1]
],
boxes: [[11,11],[12,11],[14,11],[15,11],[12,10],[15,7],[8,6],[10,6],[12,6],[15,6],[16,6],[9,5],[15,5],[9,4],[12,4],[14,4],[15,4],[16,4],[8,3],[10,3]],
goals: [[1,5],[2,5],[3,5],[4,5],[1,4],[2,4],[3,4],[4,4],[1,3],[2,3],[3,3],[4,3],[1,2],[2,2],[3,2],[4,2],[1,1],[2,1],[3,1],[4,1]],
start: [8,11]
),