LevelData(tiles: [
 [0,0,0,0,0,0,0,1,1,1,1,1,1,1,1,1,0,0,0]
,[0,0,0,1,1,1,1,1,0,0,1,1,0,0,0,1,1,0,0]
,[1,1,1,0,0,0,0,1,0,0,1,0,0,0,0,0,1,1,1]
,[1,0,0,0,0,0,0,1,0,0,1,0,0,1,0,0,0,0,1]
,[1,0,0,1,0,1,0,1,0,1,1,0,0,1,0,0,1,0,1]
,[1,0,0,0,0,0,0,0,0,1,0,0,0,1,0,1,0,0,1]
,[1,0,0,1,0,1,0,1,0,1,0,0,0,0,0,0,0,0,1]
,[1,0,0,0,0,0,0,0,0,1,1,0,0,1,1,0,0,0,1]
,[1,0,0,1,0,1,0,1,0,0,1,0,0,0,1,0,0,0,1]
,[1,0,0,0,0,0,0,0,0,0,0,0,0,0,0,0,0,1,1]
,[1,0,0,1,1,0,0,0,0,1,1,1,1,1,1,0,0,1,0]
,[1,1,1,1,1,1,1,1,1,1,0,0,0,0,1,0,0,1,0]
,[0,0,0,0,0,0,0,0,0,0,0,0,0,0,1,1,1,1,0]
],
boxes: [[16,10],[5,9],[8,9],[12,9],[15,9],[6,8],[16,8],[6,7],[8,7],[11,6],[16,6],[12,5],[11,4],[14,4],[12,3],[15,3]],
goals: [[2,9],[3,9],[4,9],[2,8],[4,8],[2,7],[4,7],[2,6],[4,6],[2,5],[4,5],[2,4],[4,4],[2,3],[3,3],[4,3]],
start: [12,4]
),