LevelData(tiles: [
 [0,1,1,1,1,1,1,1,1,0,0,0,0,0,0,0,0]
,[0,1,0,0,0,0,0,0,1,0,0,0,0,0,0,0,0]
,[0,1,1,0,0,1,0,0,1,0,0,0,0,0,0,0,0]
,[0,0,1,0,0,0,0,0,1,0,0,0,0,0,0,0,0]
,[0,0,1,0,0,0,0,1,1,0,0,0,0,0,0,0,0]
,[1,1,1,0,1,0,0,0,1,1,1,1,1,1,1,1,1]
,[1,0,0,0,0,0,0,0,1,1,0,0,0,0,0,0,1]
,[1,0,0,0,0,0,0,0,0,0,0,0,0,0,0,1,1]
,[1,1,1,1,1,1,1,1,1,1,0,0,0,0,0,0,1]
,[0,0,0,0,0,0,0,0,0,1,1,1,1,1,1,1,1]
],
boxes: [[4,7],[7,7],[3,6],[6,6],[6,5],[4,4],[6,4],[3,3],[6,3],[4,2],[6,2]],
goals: [[12,8],[13,8],[14,8],[15,8],[12,7],[13,7],[14,7],[12,6],[13,6],[14,6],[15,6]],
start: [2,1]
),