LevelData(tiles: [
 [0,0,0,0,0,1,1,1,1,0,0,0,0,0,0,0,0,0]
,[0,0,0,0,1,1,0,0,1,1,1,1,1,1,1,1,1,0]
,[1,1,1,1,1,0,0,0,0,0,0,0,0,0,0,0,1,1]
,[1,0,0,0,1,1,0,0,0,1,1,0,1,1,0,0,0,1]
,[1,0,0,0,1,1,0,1,0,0,0,0,0,0,0,1,0,1]
,[1,0,0,0,0,0,0,1,0,0,0,0,0,0,0,1,0,1]
,[1,0,0,0,0,0,0,0,0,1,1,1,0,1,0,0,0,1]
,[1,0,0,0,0,1,1,0,0,0,0,0,0,0,0,0,0,1]
,[1,1,1,1,1,1,1,0,0,0,0,0,0,0,0,1,1,1]
,[0,0,0,0,0,0,1,1,1,1,1,1,1,0,0,1,0,0]
,[0,0,0,0,0,0,0,0,0,0,0,0,1,1,1,1,0,0]
],
boxes: [[14,8],[8,7],[11,7],[12,7],[15,7],[7,6],[8,6],[14,6],[6,4],[8,4],[9,4],[11,4],[13,4],[14,4],[6,2],[13,2]],
goals: [[1,7],[2,7],[3,7],[4,7],[1,6],[2,6],[3,6],[1,5],[2,5],[3,5],[1,4],[2,4],[3,4],[1,3],[2,3],[3,3]],
start: [10,5]
),