LevelData(tiles: [
 [0,1,1,1,1,1,1,1,1,1,1,1,1,0,0,0,0]
,[1,1,0,0,0,0,0,0,0,0,0,0,1,0,0,0,0]
,[1,0,0,0,0,0,0,1,0,1,0,0,1,0,0,0,0]
,[1,0,0,1,1,0,0,1,0,1,0,0,1,0,0,0,0]
,[1,1,0,1,0,0,0,1,0,1,1,0,1,1,0,0,0]
,[0,1,0,1,0,0,0,1,0,0,0,0,0,1,0,0,0]
,[0,1,0,1,0,0,0,0,0,1,0,0,0,1,0,0,0]
,[0,1,0,1,1,0,0,0,0,0,0,0,0,1,0,0,0]
,[0,1,0,0,0,0,1,1,0,0,1,0,0,1,0,0,0]
,[0,1,0,1,0,0,0,1,1,0,0,0,0,1,0,0,0]
,[0,1,0,0,0,1,0,0,0,0,0,1,1,1,1,1,1]
,[0,1,1,1,1,1,1,1,1,0,0,1,0,0,0,0,1]
,[0,0,0,0,0,0,0,0,1,1,0,0,0,0,1,0,1]
,[0,0,0,0,0,0,0,0,1,0,0,0,0,0,0,0,1]
,[0,0,0,0,0,0,0,0,1,0,0,0,0,0,0,0,1]
,[0,0,0,0,0,0,0,0,1,1,1,1,1,1,1,1,1]
],
boxes: [[9,10],[10,10],[4,9],[5,9],[3,8],[8,7],[10,7],[7,6],[6,5],[9,5],[5,4],[8,3],[11,3],[3,2],[5,2],[6,2]],
goals: [[12,14],[13,14],[14,14],[15,14],[12,13],[13,13],[14,13],[15,13],[11,12],[12,12],[13,12],[15,12],[12,11],[13,11],[14,11],[15,11]],
start: [1,3]
),