LevelData(tiles: [
 [0,0,0,0,0,0,0,0,0,0,0,0,0,0,0,1,1,1,1]
,[0,0,1,1,1,1,1,1,1,1,1,1,1,1,1,1,0,0,1]
,[0,0,1,0,0,0,0,0,0,1,0,0,0,0,0,1,0,0,1]
,[0,0,1,0,0,0,0,1,1,1,1,1,0,0,0,1,0,0,1]
,[0,0,1,0,0,0,0,0,0,0,0,0,0,0,0,1,0,1,1]
,[1,1,1,1,0,0,1,1,1,1,1,1,0,1,1,0,0,0,1]
,[1,0,0,1,1,1,1,1,1,0,0,0,0,0,1,0,0,0,1]
,[1,0,0,1,1,1,1,1,1,0,0,0,0,0,1,0,0,1,1]
,[1,0,0,0,0,0,0,0,1,1,0,0,0,1,0,0,0,0,1]
,[1,1,1,0,1,0,1,0,0,0,0,1,0,0,0,0,0,0,1]
,[0,1,0,0,0,0,0,0,0,0,0,1,0,1,1,1,1,0,1]
,[0,1,0,0,0,1,0,0,0,0,0,0,0,0,0,0,1,0,1]
,[1,1,1,0,0,0,0,0,1,1,0,1,1,0,0,0,1,0,1]
,[1,0,0,0,1,1,1,1,1,1,0,1,1,1,1,1,1,0,1]
,[1,0,0,0,1,0,0,0,0,1,0,0,0,0,0,0,0,0,1]
,[1,1,1,1,1,0,0,0,0,1,1,1,1,1,1,1,1,1,1]
],
boxes: [[2,13],[10,13],[11,11],[6,10],[7,10],[8,10],[9,10],[10,10],[3,9],[5,9],[10,8],[11,8],[12,8],[15,8],[12,7],[16,7],[16,6],[12,5],[16,4]],
goals: [[3,4],[4,4],[5,4],[6,4],[7,4],[8,4],[9,4],[10,4],[3,3],[4,3],[5,3],[3,2],[4,2],[5,2],[6,2],[7,2],[8,2],[10,2],[11,2]],
start: [2,6]
),