LevelData(tiles: [
 [0,0,0,0,0,0,0,0,0,0,1,1,1,1,0,0]
,[1,1,1,1,1,1,1,1,1,1,1,0,0,1,0,0]
,[1,0,0,0,0,0,0,0,0,0,0,0,0,1,0,0]
,[1,0,0,0,0,0,1,0,0,0,1,0,0,1,0,0]
,[1,0,0,0,0,1,0,0,0,0,0,0,0,1,0,0]
,[1,0,1,1,1,1,0,0,1,0,1,0,0,1,1,1]
,[1,0,0,0,1,1,0,0,0,0,0,0,0,1,0,1]
,[1,0,1,0,0,0,1,0,1,0,0,0,0,0,0,1]
,[1,0,0,0,0,0,0,0,0,0,0,0,0,0,0,1]
,[1,1,1,1,1,1,1,1,1,0,0,1,1,1,1,0]
,[0,0,0,0,0,0,1,0,0,0,0,0,0,1,0,0]
,[0,0,0,0,0,0,1,0,0,0,0,0,0,1,0,0]
,[0,0,0,0,0,0,1,0,0,0,0,0,0,1,0,0]
,[0,0,0,0,0,0,1,0,0,0,0,0,0,1,0,0]
,[0,0,0,0,0,0,1,0,0,0,0,0,0,1,0,0]
,[0,0,0,0,0,0,1,1,1,1,1,1,1,1,0,0]
],
boxes: [[2,8],[4,8],[6,8],[9,8],[7,7],[10,7],[8,6],[10,6],[12,6],[11,5],[8,4],[10,4],[3,3],[8,3],[11,3],[2,2],[4,2],[8,2]],
goals: [[7,14],[8,14],[9,14],[10,14],[11,14],[12,14],[7,13],[8,13],[9,13],[10,13],[11,13],[12,13],[7,12],[8,12],[9,12],[10,12],[11,12],[12,12]],
start: [14,6]
),