LevelData(tiles: [
 [0,1,1,1,0,0,1,1,1,1,1,1]
,[1,1,0,1,1,0,1,0,0,0,0,1]
,[1,0,0,0,1,1,1,0,0,0,0,1]
,[1,0,0,0,0,0,0,0,0,0,0,1]
,[1,0,0,0,1,0,1,0,0,0,0,1]
,[1,0,0,0,1,0,1,1,1,0,0,1]
,[1,0,0,0,1,0,0,0,1,1,1,1]
,[1,0,0,0,1,0,0,0,1,0,0,0]
,[1,0,0,0,0,0,0,0,1,0,0,0]
,[1,0,0,0,1,1,0,0,1,0,0,0]
,[1,1,1,1,1,1,1,1,1,0,0,0]
],
boxes: [[3,8],[6,8],[2,7],[5,7],[3,6],[6,6],[2,5],[2,4],[2,3],[3,3]],
goals: [[9,5],[10,5],[9,4],[10,4],[9,3],[10,3],[9,2],[10,2],[9,1],[10,1]],
start: [2,1]
),