LevelData(tiles: [
 [0,0,0,0,0,0,0,0,0,0,0,1,1,1,1,1,1,0,0]
,[0,0,0,0,0,0,0,0,1,1,1,1,0,0,0,0,1,0,0]
,[0,0,0,0,0,0,0,0,1,0,0,0,0,0,1,1,1,1,1]
,[0,0,0,0,0,1,1,1,1,0,0,0,0,1,1,0,0,0,1]
,[0,0,0,0,0,1,0,0,0,0,1,1,0,0,1,0,0,0,1]
,[0,0,0,0,0,1,0,1,1,1,1,1,0,0,1,0,0,0,1]
,[0,0,0,0,0,1,0,1,0,0,0,0,0,0,0,0,0,1,1]
,[0,0,0,0,0,1,0,1,0,1,1,1,0,0,0,0,0,1,1]
,[0,0,0,0,0,1,0,1,0,1,0,0,0,0,0,1,0,1,1]
,[0,0,0,0,0,1,0,1,0,0,0,1,0,1,0,1,0,1,1]
,[1,1,1,1,1,1,0,1,0,1,0,0,0,1,1,1,0,1,1]
,[1,0,0,0,0,1,0,1,0,1,1,1,1,0,0,0,0,0,1]
,[1,0,1,0,0,0,0,0,0,0,0,0,0,0,0,0,0,0,1]
,[1,0,0,0,0,0,0,0,0,0,1,0,0,0,0,1,1,1,1]
,[1,0,0,0,0,0,1,1,0,0,1,0,0,0,0,0,0,0,1]
,[1,1,1,1,1,1,1,1,1,1,1,1,1,1,1,1,1,1,1]
],
boxes: [[8,13],[11,13],[14,13],[8,12],[13,12],[15,11],[12,9],[12,8],[13,7],[15,7],[12,6],[15,6],[16,5],[16,4],[12,2]],
goals: [[1,14],[2,14],[3,14],[4,14],[1,13],[2,13],[3,13],[4,13],[1,12],[3,12],[4,12],[1,11],[2,11],[3,11],[4,11]],
start: [12,1]
),